(
    map: (
        (V,V,V,V,V,V,V,V,V,V,),
        (V,V,V,V,V,V,V,V,V,V,),
        (V,V,V,V,V,V,V,V,V,V,),
        (V,V,V,F,F,F,F,V,V,V,),
        (V,V,V,V,F,B,F,V,V,V,),
        (V,V,V,F,F,V,V,V,V,V,),
        (V,V,V,F,F,F,Z,V,V,V,),
        (V,V,V,V,V,V,V,V,V,V,),
        (V,V,V,V,V,V,V,V,V,V,),
        (V,V,V,V,V,V,V,V,V,V,),
    ),
    character_position: (x: 3, y: 3),
    animation_row: 3,
    remaining_zones: 1,
)
