(
    map: (
        (W,W,W,W,W,W,W,W,W,W,),
        (W,W,W,W,W,W,W,W,W,W,),
        (W,W,W,W,W,W,W,W,W,W,),
        (W,W,W,F,F,F,F,W,W,W,),
        (W,W,W,W,F,B,F,W,W,W,),
        (W,W,W,F,F,W,W,W,W,W,),
        (W,W,W,F,F,F,Z,W,W,W,),
        (W,W,W,W,W,W,W,W,W,W,),
        (W,W,W,W,W,W,W,W,W,W,),
        (W,W,W,W,W,W,W,W,W,W,),
    ),
    player_position: (x: 3, y: 3),
    sprite_index: 3,
    remaining_zones: 1,
)
