(
    map: (
        (W,W,W,W,W,W,W,W,W,W,),
        (W,W,W,W,W,W,W,W,W,W,),
        (W,W,F,F,F,Z,Z,Z,W,W,),
        (W,W,F,F,B,Z,Z,P,W,W,),
        (W,W,W,B,W,W,F,Z,W,W,),
        (W,W,F,F,F,B,B,W,W,W,),
        (W,W,F,B,F,B,F,W,W,W,),
        (W,W,W,W,F,F,F,W,W,W,),
        (W,W,W,W,W,W,W,W,W,W,),
        (W,W,W,W,W,W,W,W,W,W,),
    ),
    remaining_zones: 6,
    player_position: (x: 4, y: 5),
)
