(
    map: ((
        (V,V,V,V,V,V,V,V,V,V,),
        (V,V,V,V,V,V,V,V,V,V,),
        (V,V,F,F,F,Z,Z,Z,V,V,),
        (V,V,F,F,B,Z,Z,P,V,V,),
        (V,V,V,B,V,V,F,Z,V,V,),
        (V,V,F,F,F,B,B,V,V,V,),
        (V,V,F,B,F,B,F,V,V,V,),
        (V,V,V,V,F,F,F,V,V,V,),
        (V,V,V,V,V,V,V,V,V,V,),
        (V,V,V,V,V,V,V,V,V,V,),
    )),
    character_position: (x: 4, y: 5),
    animation_row: 0,
    remaining_zones: 6,
)
