((
    map: ((
        (V,V,V,V,V,V,V,V,V,V,),
        (V,V,V,V,V,V,V,V,V,V,),
        (V,V,Z,P,Z,P,F,V,V,V,),
        (V,V,Z,Z,Z,P,F,F,V,V,),
        (V,V,V,B,V,B,B,F,V,V,),
        (V,V,F,F,F,B,F,F,V,V,),
        (V,V,F,B,V,F,F,V,V,V,),
        (V,V,F,F,F,F,V,V,V,V,),
        (V,V,V,V,V,V,V,V,V,V,),
        (V,V,V,V,V,V,V,V,V,V,),
    )),
    character_position: (x: 2, y: 6),
    character_facing_direction: 1,
    remaining_zones: 5,
))
