(
    map: (
        (W,W,W,W,W,W,W,W,W,W,),
        (W,W,W,W,W,W,W,W,W,W,),
        (W,W,Z,P,Z,P,F,W,W,W,),
        (W,W,Z,Z,Z,P,F,F,W,W,),
        (W,W,W,B,W,B,B,F,W,W,),
        (W,W,F,F,F,B,F,F,W,W,),
        (W,W,F,B,W,F,F,W,W,W,),
        (W,W,F,F,F,F,W,W,W,W,),
        (W,W,W,W,W,W,W,W,W,W,),
        (W,W,W,W,W,W,W,W,W,W,),
    ),
    player_position: (x: 2, y: 6),
    sprite_index: 0,
    remaining_zones: 5,
)
