(
    map: (
        (W,W,W,W,W,W,W,W,W,W,),
        (W,F,F,F,W,W,W,F,F,W,),
        (W,F,B,F,F,F,B,B,F,W,),
        (W,F,F,F,W,F,F,F,F,W,),
        (W,W,F,W,W,B,F,W,W,W,),
        (W,W,F,F,F,B,B,F,W,W,),
        (W,W,F,B,W,P,Z,Z,W,W,),
        (W,W,F,F,W,Z,P,Z,W,W,),
        (W,W,W,W,W,Z,Z,Z,W,W,),
        (W,W,W,W,W,W,W,W,W,W,),
    ),
    character_position: (x: 4, y: 2),
    animation_row: 3,
    remaining_zones: 7,
)
