(
    map: (
        (V,V,V,V,V,V,V,V,V,V,),
        (V,F,F,F,V,V,V,F,F,V,),
        (V,F,B,F,F,F,B,B,F,V,),
        (V,F,F,F,V,F,F,F,F,V,),
        (V,V,F,V,V,B,F,V,V,V,),
        (V,V,F,F,F,B,B,F,V,V,),
        (V,V,F,B,V,P,Z,Z,V,V,),
        (V,V,F,F,V,Z,P,Z,V,V,),
        (V,V,V,V,V,Z,Z,Z,V,V,),
        (V,V,V,V,V,V,V,V,V,V,),
    ),
    character_position: (x: 4, y: 2),
    animation_row: 3,
    remaining_zones: 7,
)
