(
    map: (
        (W,W,W,W,W,W,W,W,W,W,),
        (W,F,F,F,W,W,F,F,F,W,),
        (W,F,B,F,F,F,F,B,F,W,),
        (W,F,B,F,W,W,F,F,F,W,),
        (W,W,F,W,W,W,W,F,W,W,),
        (W,W,F,W,W,W,W,F,W,W,),
        (W,Z,B,F,W,W,F,F,F,W,),
        (W,Z,P,F,F,F,F,B,F,W,),
        (W,Z,Z,Z,W,W,F,F,F,W,),
        (W,W,W,W,W,W,W,W,W,W,),
    ),
    character_position: (x: 8, y: 1),
    animation_row: 2,
    remaining_zones: 5,
)
