((
    map: ((
        (V,V,V,V,V,V,V,V,V,V,),
        (V,F,F,F,V,V,F,F,F,V,),
        (V,F,B,F,F,F,F,B,F,V,),
        (V,F,B,F,V,V,F,F,F,V,),
        (V,V,F,V,V,V,V,F,V,V,),
        (V,V,F,V,V,V,V,F,V,V,),
        (V,Z,B,F,V,V,F,F,F,V,),
        (V,Z,P,F,F,F,F,B,F,V,),
        (V,Z,Z,Z,V,V,F,F,F,V,),
        (V,V,V,V,V,V,V,V,V,V,),
    )),
    character_position: (x: 8, y: 1),
    character_facing_direction: 2,
    remaining_zones: 5,
))
