((
    map: ((
        (V,V,V,V,V,V,V,V,V,V,),
        (V,F,B,F,Z,Z,Z,Z,Z,V,),
        (V,F,F,V,V,B,V,V,Z,V,),
        (V,F,F,V,F,F,F,V,Z,V,),
        (V,V,F,F,B,F,F,F,Z,V,),
        (V,V,B,B,V,B,F,V,Z,V,),
        (V,V,F,F,B,F,V,V,F,V,),
        (V,V,F,F,B,F,F,B,F,V,),
        (V,V,V,V,V,V,F,F,F,V,),
        (V,V,V,V,V,V,V,V,V,V,),
    )),
    character_position: (x: 2, y: 7),
    character_facing_direction: 1,
    remaining_zones: 9,
))
