(
    map: (
        (W,W,W,W,W,W,W,W,W,W,),
        (W,F,B,F,Z,Z,Z,Z,Z,W,),
        (W,F,F,W,W,B,W,W,Z,W,),
        (W,F,F,W,F,F,F,W,Z,W,),
        (W,W,F,F,B,F,F,F,Z,W,),
        (W,W,B,B,W,B,F,W,Z,W,),
        (W,W,F,F,B,F,W,W,F,W,),
        (W,W,F,F,B,F,F,B,F,W,),
        (W,W,W,W,W,W,F,F,F,W,),
        (W,W,W,W,W,W,W,W,W,W,),
    ),
    player_position: (x: 2, y: 7),
    remaining_zones: 9,
)
