(
    map: (
        (V,V,V,V,V,V,V,V,V,V,),
        (V,V,V,V,Z,B,F,F,Z,V,),
        (V,V,F,B,F,B,F,F,F,V,),
        (V,V,Z,F,F,Z,V,B,V,V,),
        (V,V,V,B,V,V,V,F,Z,V,),
        (V,V,F,F,F,V,V,F,F,V,),
        (V,V,B,F,B,V,Z,B,F,V,),
        (V,Z,F,F,B,F,F,F,Z,V,),
        (V,Z,B,F,Z,V,V,V,V,V,),
        (V,V,V,V,V,V,V,V,V,V,),
    ),
    character_position: (x: 3, y: 3),
    animation_row: 3,
    remaining_zones: 10,
)
