(
    map: (
        (W,W,W,W,W,W,W,W,W,W,),
        (W,F,F,W,W,F,F,F,F,W,),
        (W,W,B,W,W,F,W,W,F,W,),
        (W,F,F,F,F,F,W,Z,F,W,),
        (W,F,F,W,Z,B,F,F,F,W,),
        (W,W,F,W,W,W,W,F,W,W,),
        (W,F,F,F,F,F,W,F,W,W,),
        (W,F,B,F,W,F,W,F,W,W,),
        (W,F,F,F,W,F,F,F,Z,W,),
        (W,W,W,W,W,W,W,W,W,W,),
    ),
    player_position: (x: 1, y: 1),
    sprite_index: 0,
    remaining_zones: 3,
)
