(
    map: ((
        (V,V,V,V,V,V,V,V,V,V,),
        (V,F,F,V,V,F,F,F,F,V,),
        (V,V,B,V,V,F,V,V,F,V,),
        (V,F,F,F,F,F,V,Z,F,V,),
        (V,F,F,V,Z,B,F,F,F,V,),
        (V,V,F,V,V,V,V,F,V,V,),
        (V,F,F,F,F,F,V,F,V,V,),
        (V,F,B,F,V,F,V,F,V,V,),
        (V,F,F,F,V,F,F,F,Z,V,),
        (V,V,V,V,V,V,V,V,V,V,),
    )),
    character_position: (x: 1, y: 1),
    animation_row: 3,
    remaining_zones: 3,
)
