(
    map: (
        (V,V,V,V,V,V,V,V,V,V,),
        (V,V,V,V,V,V,V,V,V,V,),
        (V,V,V,V,V,V,V,V,V,V,),
        (V,V,V,F,F,F,F,V,V,V,),
        (V,V,V,F,V,V,F,V,V,V,),
        (V,V,V,F,B,F,F,V,V,V,),
        (V,V,V,F,V,V,Z,V,V,V,),
        (V,V,V,V,V,V,V,V,V,V,),
        (V,V,V,V,V,V,V,V,V,V,),
        (V,V,V,V,V,V,V,V,V,V,),
    ),
    character_position: (x: 3, y: 6),
    animation_row: 1,
    remaining_zones: 1,
)
