(
    map: (
        (W,W,W,W,W,W,W,W,W,W,),
        (W,W,W,W,W,W,W,W,W,W,),
        (W,W,W,W,W,W,W,W,W,W,),
        (W,W,W,F,F,F,F,W,W,W,),
        (W,W,W,F,W,W,F,W,W,W,),
        (W,W,W,F,B,F,F,W,W,W,),
        (W,W,W,F,W,W,Z,W,W,W,),
        (W,W,W,W,W,W,W,W,W,W,),
        (W,W,W,W,W,W,W,W,W,W,),
        (W,W,W,W,W,W,W,W,W,W,),
    ),
    player_position: (x: 3, y: 6),
    remaining_zones: 1,
)
