(
    map: (
        (W,W,W,W,W,W,W,W,W,W,),
        (W,W,W,W,W,W,W,W,W,W,),
        (W,W,W,W,W,W,W,W,W,W,),
        (W,W,W,Z,B,F,Z,W,W,W,),
        (W,W,W,F,F,B,F,W,W,W,),
        (W,W,W,F,B,W,F,W,W,W,),
        (W,W,W,F,F,W,Z,W,W,W,),
        (W,W,W,W,W,W,W,W,W,W,),
        (W,W,W,W,W,W,W,W,W,W,),
        (W,W,W,W,W,W,W,W,W,W,),
    ),
    player_position: (x: 4, y: 6),
    sprite_index: 0,
    remaining_zones: 3,
)
