((
    map: ((
        (V,V,V,V,V,V,V,V,V,V,),
        (V,V,V,V,V,V,V,V,V,V,),
        (V,V,V,V,V,V,V,V,V,V,),
        (V,V,V,Z,B,F,Z,V,V,V,),
        (V,V,V,F,F,B,F,V,V,V,),
        (V,V,V,F,B,V,F,V,V,V,),
        (V,V,V,F,F,V,Z,V,V,V,),
        (V,V,V,V,V,V,V,V,V,V,),
        (V,V,V,V,V,V,V,V,V,V,),
        (V,V,V,V,V,V,V,V,V,V,),
    )),
    character_position: (x: 4, y: 6),
    character_facing_direction: 2,
    remaining_zones: 3,
))
