(
    map: ((
        (V,V,V,V,V,V,V,V,V,V,),
        (V,V,V,V,V,V,V,V,V,V,),
        (V,V,V,V,V,V,V,V,V,V,),
        (V,V,V,Z,F,F,Z,V,V,V,),
        (V,V,V,F,B,B,F,V,V,V,),
        (V,V,V,V,B,F,F,V,V,V,),
        (V,V,V,Z,F,F,V,V,V,V,),
        (V,V,V,V,V,V,V,V,V,V,),
        (V,V,V,V,V,V,V,V,V,V,),
        (V,V,V,V,V,V,V,V,V,V,),
    )),
    character_position: (x: 3, y: 4),
    animation_row: 1,
    remaining_zones: 3,
)
