((
    map: ((
        (V,V,V,V,V,V,V,V,V,V,),
        (V,V,V,V,V,V,V,V,V,V,),
        (V,V,V,V,V,V,V,V,V,V,),
        (V,V,V,F,F,F,F,V,V,V,),
        (V,V,V,F,V,B,F,V,V,V,),
        (V,V,V,F,B,Z,F,V,V,V,),
        (V,V,V,V,Z,P,F,V,V,V,),
        (V,V,V,V,V,V,V,V,V,V,),
        (V,V,V,V,V,V,V,V,V,V,),
        (V,V,V,V,V,V,V,V,V,V,),
    )),
    character_position: (x: 4, y: 3),
    character_facing_direction: 3,
    remaining_zones: 2,
))
