(
    map: (
        (W,W,W,W,W,W,W,W,W,W,),
        (W,W,W,W,W,W,W,W,W,W,),
        (W,W,W,W,W,W,W,W,W,W,),
        (W,W,W,F,F,F,F,W,W,W,),
        (W,W,W,F,W,B,F,W,W,W,),
        (W,W,W,F,B,Z,F,W,W,W,),
        (W,W,W,W,Z,P,F,W,W,W,),
        (W,W,W,W,W,W,W,W,W,W,),
        (W,W,W,W,W,W,W,W,W,W,),
        (W,W,W,W,W,W,W,W,W,W,),
    ),
    player_position: (x: 4, y: 3),
    sprite_index: 0,
    remaining_zones: 2,
)
