(
    map: (
        (W,W,W,W,W,W,W,W,W,W,),
        (W,W,W,W,W,W,W,W,W,W,),
        (W,W,Z,W,F,F,F,F,W,W,),
        (W,W,Z,W,F,B,B,F,W,W,),
        (W,W,Z,W,F,F,B,F,W,W,),
        (W,W,Z,W,W,F,F,F,W,W,),
        (W,W,F,F,B,F,F,W,W,W,),
        (W,W,F,F,W,F,F,W,W,W,),
        (W,W,W,W,W,W,W,W,W,W,),
        (W,W,W,W,W,W,W,W,W,W,),
    ),
    player_position: (x: 2, y: 7),
    sprite_index: 0,
    remaining_zones: 4,
)
