(
    map: (
        (V,V,V,V,V,V,V,V,V,V,),
        (V,V,V,V,V,V,V,V,V,V,),
        (V,V,Z,V,F,F,F,F,V,V,),
        (V,V,Z,V,F,B,B,F,V,V,),
        (V,V,Z,V,F,F,B,F,V,V,),
        (V,V,Z,V,V,F,F,F,V,V,),
        (V,V,F,F,B,F,F,V,V,V,),
        (V,V,F,F,V,F,F,V,V,V,),
        (V,V,V,V,V,V,V,V,V,V,),
        (V,V,V,V,V,V,V,V,V,V,),
    ),
    character_position: (x: 2, y: 7),
    animation_row: 1,
    remaining_zones: 4,
)
