(
    map: (
        (W,W,W,W,W,W,W,W,W,W,),
        (W,W,W,W,W,W,W,W,W,W,),
        (W,W,Z,Z,Z,W,W,F,W,W,),
        (W,W,W,F,F,F,B,F,W,W,),
        (W,W,W,B,B,F,W,F,W,W,),
        (W,W,W,F,B,F,W,F,W,W,),
        (W,W,W,F,W,W,W,F,W,W,),
        (W,W,Z,F,F,F,F,F,W,W,),
        (W,W,W,W,W,W,W,W,W,W,),
        (W,W,W,W,W,W,W,W,W,W,),
    ),
    player_position: (x: 7, y: 2),
    sprite_index: 0,
    remaining_zones: 4,
)
