(
    map: (
        (V,V,V,V,V,V,V,V,V,V,),
        (V,V,V,V,V,V,V,V,V,V,),
        (V,V,Z,Z,Z,V,V,F,V,V,),
        (V,V,V,F,F,F,B,F,V,V,),
        (V,V,V,B,B,F,V,F,V,V,),
        (V,V,V,F,B,F,V,F,V,V,),
        (V,V,V,F,V,V,V,F,V,V,),
        (V,V,Z,F,F,F,F,F,V,V,),
        (V,V,V,V,V,V,V,V,V,V,),
        (V,V,V,V,V,V,V,V,V,V,),
    ),
    character_position: (x: 7, y: 2),
    animation_row: 0,
    remaining_zones: 4,
)
