(
    map: (
        (W,W,W,W,W,W,W,W,W,W,),
        (W,W,W,W,W,W,W,W,W,W,),
        (W,W,W,F,F,F,F,F,W,W,),
        (W,W,W,F,B,F,B,F,W,W,),
        (W,W,W,F,W,W,W,F,W,W,),
        (W,W,Z,F,B,Z,F,F,W,W,),
        (W,W,Z,B,F,F,B,F,W,W,),
        (W,W,W,W,Z,Z,W,W,W,W,),
        (W,W,W,W,W,W,W,W,W,W,),
        (W,W,W,W,W,W,W,W,W,W,),
    ),
    player_position: (x: 5, y: 3),
    sprite_index: 0,
    remaining_zones: 5,
)
