(
    map: (
        (V,V,V,V,V,V,V,V,V,V,),
        (V,V,V,V,V,V,V,V,V,V,),
        (V,V,V,F,F,F,F,F,V,V,),
        (V,V,V,F,B,F,B,F,V,V,),
        (V,V,V,F,V,V,V,F,V,V,),
        (V,V,Z,F,B,Z,F,F,V,V,),
        (V,V,Z,B,F,F,B,F,V,V,),
        (V,V,V,V,Z,Z,V,V,V,V,),
        (V,V,V,V,V,V,V,V,V,V,),
        (V,V,V,V,V,V,V,V,V,V,),
    ),
    character_position: (x: 5, y: 3),
    animation_row: 1,
    remaining_zones: 5,
)
