((
    map: ((
        (V,V,V,V,V,V,V,V,V,V,),
        (V,V,V,V,V,V,V,V,V,V,),
        (V,V,Z,Z,Z,Z,Z,Z,V,V,),
        (V,V,F,F,B,F,F,F,V,V,),
        (V,V,B,F,V,V,B,F,V,V,),
        (V,V,F,B,F,F,B,F,V,V,),
        (V,V,F,V,F,F,F,B,V,V,),
        (V,V,F,F,F,F,F,F,V,V,),
        (V,V,V,V,V,V,V,V,V,V,),
        (V,V,V,V,V,V,V,V,V,V,),
    )),
    character_position: (x: 6, y: 6),
    character_facing_direction: 0,
    remaining_zones: 6,
))
