(
    map: (
        (W,W,W,W,W,W,W,W,W,W,),
        (W,W,W,W,W,W,W,W,W,W,),
        (W,W,Z,Z,Z,Z,Z,Z,W,W,),
        (W,W,F,F,B,F,F,F,W,W,),
        (W,W,B,F,W,W,B,F,W,W,),
        (W,W,F,B,F,F,B,F,W,W,),
        (W,W,F,W,F,F,F,B,W,W,),
        (W,W,F,F,F,F,F,F,W,W,),
        (W,W,W,W,W,W,W,W,W,W,),
        (W,W,W,W,W,W,W,W,W,W,),
    ),
    player_position: (x: 6, y: 6),
    remaining_zones: 6,
)
