(
    map: (
        (W,W,W,W,W,W,W,W,W,W,),
        (W,W,W,W,Z,B,F,F,Z,W,),
        (W,W,F,B,F,B,F,F,F,W,),
        (W,W,Z,F,F,Z,W,B,W,W,),
        (W,W,W,B,W,W,W,F,Z,W,),
        (W,W,F,F,F,W,W,F,F,W,),
        (W,W,B,F,B,W,Z,B,F,W,),
        (W,Z,F,F,B,F,F,F,Z,W,),
        (W,Z,B,F,Z,W,W,W,W,W,),
        (W,W,W,W,W,W,W,W,W,W,),
    ),
    remaining_zones: 10,
    player_position: (x: 3, y: 3),
)
