(
    map: (
        (W,W,W,W,W,W,W,W,W,W,),
        (W,W,W,W,W,W,W,W,W,W,),
        (W,W,W,W,W,W,W,W,W,W,),
        (W,W,W,Z,F,F,Z,W,W,W,),
        (W,W,W,F,B,B,F,W,W,W,),
        (W,W,W,W,B,F,F,W,W,W,),
        (W,W,W,Z,F,F,W,W,W,W,),
        (W,W,W,W,W,W,W,W,W,W,),
        (W,W,W,W,W,W,W,W,W,W,),
        (W,W,W,W,W,W,W,W,W,W,),
    ),
    remaining_zones: 3,
    player_position: (x: 3, y: 4),
)
